10 6
00000XXXXX
00XE000000
XXXXXXX000
0X0S00XX00
00XXX0000X
X0000000XX

